#############
#           #
# S         #
#           #
#  #######  #
#  #     #  #
#  #  ## #  #
#  #  E# #  #
#  #   # #  #
#  #####    #
#           #
#############