##########
#        #
#  S     #
# ###### #
#    E   #
#        #
##########
